station_id,capacity,docks_total,diff_net,ape_net,capacity_calib,diff_calib,ape_calib
30200,0,15,-15,100.0,8.707697090855955,-6.292302909144045,41.9486860609603
30201,0,11,-11,100.0,8.707697090855955,-2.2923029091440448,20.839117355854953
31000,21,12,9,75.0,9.563106995550378,-2.4368930044496224,20.307441703746854
31002,37,7,30,428.57142857142856,10.214847875317558,3.214847875317558,45.92639821882226
31003,20,5,15,300.0,9.52237319056493,4.522373190564929,90.44746381129858
31004,17,3,14,466.6666666666667,9.400171775608584,6.400171775608584,213.3390591869528
31005,26,5,21,420.0,9.766776020477622,4.7667760204776215,95.33552040955243
31006,22,1,21,2100.0,9.603840800535828,8.603840800535828,860.3840800535828
31007,29,8,21,262.5,9.888977435433969,1.8889774354339686,23.61221794292461
31009,17,8,9,112.5,9.400171775608584,1.4001717756085839,17.502147195107298
31010,0,8,-8,100.0,8.707697090855955,0.7076970908559552,8.84621363569944
31011,0,12,-12,100.0,8.707697090855955,-3.2923029091440448,27.435857576200373
31012,0,8,-8,100.0,8.707697090855955,0.7076970908559552,8.84621363569944
31013,16,6,10,166.66666666666669,9.359437970623135,3.3594379706231354,55.99063284371893
31014,99,10,89,890.0,12.740343784415378,2.740343784415378,27.403437844153782
31015,67,11,56,509.09090909090907,11.43686202488102,0.43686202488101955,3.9714729534638145
31016,22,12,10,83.33333333333334,9.603840800535828,-2.396159199464172,19.967993328868104
31017,166,13,153,1176.923076923077,15.469508718440443,2.4695087184404425,18.99622091108033
31018,44,2,42,2100.0,10.499984510215699,8.499984510215699,424.9992255107849
31019,80,10,70,700.0,11.966401489691853,1.9664014896918527,19.664014896918527
31020,83,7,76,1085.7142857142858,12.088602904648198,5.088602904648198,72.69432720925997
31021,22,14,8,57.14285714285714,9.603840800535828,-4.396159199464172,31.4011371390298
31022,226,18,208,1155.5555555555554,17.913537017567364,-0.08646298243263573,0.4803499024035318
31023,25,10,15,150.0,9.726042215492173,-0.27395778450782693,2.7395778450782693
31024,87,8,79,987.5,12.251538124589993,4.2515381245899935,53.14422655737492
31025,48,10,38,380.0,10.662919730157494,0.6629197301574941,6.629197301574941
31026,28,15,13,86.66666666666667,9.84824363044852,-5.15175636955148,34.345042463676535
31027,50,15,35,233.33333333333334,10.744387340128391,-4.255612659871609,28.37075106581073
31028,42,12,30,250.0,10.418516900244802,-1.5814830997551983,13.17902583129332
31029,31,13,18,138.46153846153845,9.970445045404865,-3.0295549545951346,23.304268881501038
31030,188,14,174,1242.857142857143,16.365652428120313,2.3656524281203133,16.897517343716522
31031,70,13,57,438.4615384615385,11.559063439837367,-1.4409365601626334,11.08412738586641
31032,12,7,5,71.42857142857143,9.19650275068134,2.19650275068134,31.37861072401914
31033,9,1,8,800.0,9.074301335724993,8.074301335724993,807.4301335724992
31034,16,11,5,45.45454545454545,9.359437970623135,-1.6405620293768646,14.914200267062405
31035,19,3,16,533.3333333333333,9.48163938557948,6.481639385579481,216.05464618598268
31036,29,7,22,314.2857142857143,9.888977435433969,2.8889774354339686,41.271106220485265
31037,64,21,43,204.76190476190476,11.314660609924672,-9.685339390075328,46.12066376226346
31038,30,9,21,233.33333333333334,9.929711240419417,0.929711240419417,10.330124893549078
31039,59,13,46,353.8461538461538,11.11099158499743,-1.8890084150025697,14.530833961558228
31040,21,6,15,250.0,9.563106995550378,3.5631069955503776,59.38511659250629
31041,63,1,62,6200.0,11.273926804939224,10.273926804939224,1027.3926804939224
31042,56,6,50,833.3333333333334,10.988790170041083,4.988790170041083,83.14650283401805
31043,30,4,26,650.0,9.929711240419417,5.929711240419417,148.24278101048543
31044,10,6,4,66.66666666666666,9.115035140710443,3.115035140710443,51.91725234517405
31045,26,7,19,271.42857142857144,9.766776020477622,2.7667760204776215,39.525371721108876
31046,12,6,6,100.0,9.19650275068134,3.19650275068134,53.275045844689
31047,10,13,-3,23.076923076923077,9.115035140710443,-3.884964859289557,29.884345071458128
31048,11,19,-8,42.10526315789473,9.155768945695892,-9.844231054304108,51.811742391074254
31049,43,5,38,760.0,10.45925070523025,5.45925070523025,109.18501410460499
31050,15,8,7,87.5,9.318704165637685,1.3187041656376852,16.483802070471064
31051,18,7,11,157.14285714285714,9.440905580594032,2.4409055805940323,34.87007972277189
31052,35,8,27,337.5,10.133380265346661,2.133380265346661,26.66725331683326
31053,26,7,19,271.42857142857144,9.766776020477622,2.7667760204776215,39.525371721108876
31054,10,5,5,100.0,9.115035140710443,4.115035140710443,82.30070281420886
31055,20,7,13,185.71428571428572,9.52237319056493,2.522373190564929,36.03390272235613
31057,13,11,2,18.181818181818183,9.237236555666788,-1.7627634443332116,16.025122221211017
31058,17,7,10,142.85714285714286,9.400171775608584,2.400171775608584,34.28816822297977
31059,12,4,8,200.0,9.19650275068134,5.19650275068134,129.9125687670335
31060,29,10,19,190.0,9.888977435433969,-0.11102256456603143,1.1102256456603143
31061,19,9,10,111.11111111111111,9.48163938557948,0.4816393855794807,5.351548728660896
31062,19,4,15,375.0,9.48163938557948,5.481639385579481,137.04098463948702
31063,8,2,6,300.0,9.033567530739544,7.033567530739544,351.6783765369772
31064,31,3,28,933.3333333333334,9.970445045404865,6.970445045404865,232.3481681801622
31065,41,8,33,412.5,10.377783095259353,2.3777830952593533,29.722288690741916
31066,7,4,3,75.0,8.992833725754096,4.992833725754096,124.8208431438524
31067,19,7,12,171.42857142857142,9.48163938557948,2.4816393855794807,35.45199122256401
31068,44,7,37,528.5714285714286,10.499984510215699,3.4999845102156986,49.99977871736712
31069,18,8,10,125.0,9.440905580594032,1.4409055805940323,18.011319757425404
31070,9,7,2,28.57142857142857,9.074301335724993,2.074301335724993,29.632876224642757
31071,33,8,25,312.5,10.051912655375762,2.0519126553757623,25.648908192197027
31072,6,6,0,0.0,8.952099920768648,2.9520999207686476,49.201665346144125
31073,19,5,14,280.0,9.48163938557948,4.481639385579481,89.63278771158961
31075,11,1,10,1000.0,9.155768945695892,8.155768945695892,815.5768945695892
31076,10,7,3,42.857142857142854,9.115035140710443,2.115035140710443,30.2147877244349
31077,23,14,9,64.28571428571429,9.644574605521276,-4.355425394478724,31.11018138913374
31078,26,2,24,1200.0,9.766776020477622,7.7667760204776215,388.33880102388105
31079,21,4,17,425.0,9.563106995550378,5.563106995550378,139.07767488875945
31080,31,15,16,106.66666666666667,9.970445045404865,-5.029554954595135,33.53036636396756
31081,15,5,10,200.0,9.318704165637685,4.318704165637685,86.3740833127537
31082,19,13,6,46.15384615384615,9.48163938557948,-3.5183606144205193,27.06431241861938
31083,11,9,2,22.22222222222222,9.155768945695892,0.1557689456958915,1.7307660632876833
31084,12,12,0,0.0,9.19650275068134,-2.80349724931866,23.362477077655498
31085,20,10,10,100.0,9.52237319056493,-0.47762680943507085,4.7762680943507085
31086,9,2,7,350.0,9.074301335724993,7.074301335724993,353.7150667862496
31087,20,14,6,42.857142857142854,9.52237319056493,-4.477626809435071,31.983048638821938
31088,21,8,13,162.5,9.563106995550378,1.5631069955503776,19.53883744437972
31089,19,16,3,18.75,9.48163938557948,-6.518360614420519,40.739753840128245
31090,19,3,16,533.3333333333333,9.48163938557948,6.481639385579481,216.05464618598268
31091,18,3,15,500.0,9.440905580594032,6.440905580594032,214.69685268646774
31092,29,1,28,2800.0,9.888977435433969,8.888977435433969,888.8977435433968
31093,36,11,25,227.27272727272728,10.17411407033211,-0.8258859296678907,7.5080539060717335
31094,20,5,15,300.0,9.52237319056493,4.522373190564929,90.44746381129858
31095,11,8,3,37.5,9.155768945695892,1.1557689456958915,14.447111821198643
31096,14,9,5,55.55555555555556,9.277970360652237,0.2779703606522368,3.0885595628026308
31098,23,1,22,2200.0,9.644574605521276,8.644574605521276,864.4574605521276
31099,11,14,-3,21.428571428571427,9.155768945695892,-4.8442310543041085,34.60165038788649
31100,0,15,-15,100.0,8.707697090855955,-6.292302909144045,41.9486860609603
31101,0,1,-1,100.0,8.707697090855955,7.707697090855955,770.7697090855955
31102,0,36,-36,100.0,8.707697090855955,-27.292302909144045,75.81195252540013
31104,0,8,-8,100.0,8.707697090855955,0.7076970908559552,8.84621363569944
31105,0,16,-16,100.0,8.707697090855955,-7.292302909144045,45.57689318215028
31106,0,15,-15,100.0,8.707697090855955,-6.292302909144045,41.9486860609603
31107,0,11,-11,100.0,8.707697090855955,-2.2923029091440448,20.839117355854953
31108,0,21,-21,100.0,8.707697090855955,-12.292302909144045,58.53477575782878
31109,0,6,-6,100.0,8.707697090855955,2.7076970908559552,45.128284847599254
31110,0,9,-9,100.0,8.707697090855955,-0.2923029091440448,3.2478101016004977
31111,0,13,-13,100.0,8.707697090855955,-4.292302909144045,33.01771468572342
31112,0,11,-11,100.0,8.707697090855955,-2.2923029091440448,20.839117355854953
31113,0,10,-10,100.0,8.707697090855955,-1.2923029091440448,12.923029091440446
31114,0,9,-9,100.0,8.707697090855955,-0.2923029091440448,3.2478101016004977
31115,266,13,253,1946.153846153846,19.542889216985316,6.542889216985316,50.3299170537332
31116,0,10,-10,100.0,8.707697090855955,-1.2923029091440448,12.923029091440446
31117,0,6,-6,100.0,8.707697090855955,2.7076970908559552,45.128284847599254
31118,0,2,-2,100.0,8.707697090855955,6.707697090855955,335.38485454279777
31119,0,15,-15,100.0,8.707697090855955,-6.292302909144045,41.9486860609603
31120,0,9,-9,100.0,8.707697090855955,-0.2923029091440448,3.2478101016004977
31121,0,14,-14,100.0,8.707697090855955,-5.292302909144045,37.802163636743174
31122,86,7,79,1128.5714285714287,12.210804319604545,5.210804319604545,74.44006170863636
31123,95,14,81,578.5714285714286,12.577408564473583,-1.4225914355264173,10.161367396617267
31124,80,23,57,247.82608695652172,11.966401489691853,-11.033598510308147,47.97216743612238
31125,53,7,46,657.1428571428571,10.866588755084738,3.866588755084738,55.236982215496255
31126,54,8,46,575.0,10.907322560070186,2.9073225600701864,36.34153200087733
31127,29,10,19,190.0,9.888977435433969,-0.11102256456603143,1.1102256456603143
31128,144,14,130,928.5714285714287,14.573365008760572,0.5733650087605717,4.095464348289798
31129,108,5,103,2060.0,13.106948029284418,8.106948029284418,162.13896058568835
31130,72,11,61,554.5454545454546,11.640531049808263,0.6405310498082635,5.823009543711486
31131,277,11,266,2418.1818181818185,19.99096107182525,8.99096107182525,81.7360097438659
31132,56,12,44,366.66666666666663,10.988790170041083,-1.0112098299589167,8.426748582990973
31133,132,8,124,1550.0,14.084559348935187,6.084559348935187,76.05699186168984
31134,126,12,114,950.0,13.840156519022493,1.8401565190224929,15.334637658520775
31135,181,18,163,905.5555555555555,16.080515793222173,-1.9194842067778275,10.663801148765709
31136,167,19,148,778.9473684210526,15.510242523425891,-3.489757476574109,18.367144613547943
31137,102,14,88,628.5714285714286,12.862545199371723,-1.1374548006282765,8.124677147344832
31138,30,7,23,328.57142857142856,9.929711240419417,2.929711240419417,41.853017720277386
31139,44,11,33,300.0,10.499984510215699,-0.5000154897843014,4.545595361675468
31140,32,14,18,128.57142857142858,10.011178850390314,-3.988821149609686,28.491579640069187
31201,41,16,25,156.25,10.377783095259353,-5.622216904740647,35.13885565462904
31202,73,16,57,356.25,11.681264854793712,-4.318735145206288,26.9920946575393
31203,127,13,114,876.923076923077,13.880890324007943,0.8808903240079431,6.776079415445715
31204,35,7,28,400.0,10.133380265346661,3.133380265346661,44.762575219238016
31205,120,39,81,207.6923076923077,13.595753689109802,-25.404246310890198,65.13909310484665
31206,25,7,18,257.14285714285717,9.726042215492173,2.726042215492173,38.943460221316755
31207,21,15,6,40.0,9.563106995550378,-5.436893004449622,36.24595336299748
31208,92,12,80,666.6666666666667,12.455207149517237,0.4552071495172374,3.793392912643645
31209,210,13,197,1515.3846153846152,17.261796137800186,4.261796137800186,32.78304721384758
31210,63,15,48,320.0,11.273926804939224,-3.726073195060776,24.84048796707184
31211,30,2,28,1400.0,9.929711240419417,7.929711240419417,396.48556202097086
31212,82,5,77,1540.0,12.047869099662751,7.047869099662751,140.957381993255
31213,122,3,119,3966.6666666666665,13.6772212990807,10.6772212990807,355.90737663602334
31214,59,17,42,247.05882352941177,11.11099158499743,-5.88900841500257,34.64122597060335
31215,226,8,218,2725.0,17.913537017567364,9.913537017567364,123.91921271959205
31216,207,25,182,728.0,17.13959472284384,-7.860405277156161,31.441621108624645
31217,131,36,95,263.88888888888886,14.043825543949737,-21.956174456050263,60.98937348902851
31218,50,11,39,354.54545454545456,10.744387340128391,-0.2556126598716091,2.3237514533782644
31219,66,43,23,53.48837209302325,11.396128219895571,-31.603871780104427,73.49737623280099
31220,33,2,31,1550.0,10.051912655375762,8.051912655375762,402.5956327687881
31221,113,21,92,438.09523809523813,13.310617054211662,-7.6893829457883385,36.61610926565875
31222,168,17,151,888.2352941176471,15.550976328411341,-1.4490236715886589,8.523668656403876
31223,86,17,69,405.88235294117646,12.210804319604545,-4.789195680395455,28.171739296443853
31224,68,8,60,750.0,11.477595829866468,3.477595829866468,43.46994787333085
31225,275,15,260,1733.3333333333333,19.909493461854353,4.909493461854353,32.729956412362355
31226,45,5,40,800.0,10.540718315201147,5.540718315201147,110.81436630402295
31227,155,25,130,520.0,15.021436863600506,-9.978563136399494,39.914252545597975
31228,298,30,268,893.3333333333334,20.846370976519673,-9.153629023480327,30.512096744934425
31229,217,1,216,21600.0,17.546932772698327,16.546932772698327,1654.6932772698326
31230,300,17,283,1664.7058823529412,20.927838586490573,3.927838586490573,23.10493286170925
31231,134,13,121,930.7692307692308,14.166026958906084,1.1660269589060839,8.969438145431415
31232,156,20,136,680.0,15.062170668585956,-4.937829331414044,24.689146657070218
31233,155,34,121,355.88235294117646,15.021436863600506,-18.978563136399494,55.81930334235145
31234,78,30,48,160.0,11.884933879720956,-18.115066120279046,60.38355373426349
31235,88,31,57,183.8709677419355,12.292271929575442,-18.707728070424558,60.347509904595356
31236,86,12,74,616.6666666666667,12.210804319604545,0.21080431960454504,1.7567026633712086
31238,133,23,110,478.2608695652174,14.125293153920635,-8.874706846079365,38.5856819394755
31239,54,19,35,184.21052631578948,10.907322560070186,-8.092677439929814,42.59303915752534
31240,48,25,23,92.0,10.662919730157494,-14.337080269842506,57.348321079370024
31241,173,10,163,1630.0,15.754645353338585,5.754645353338585,57.54645353338586
31242,56,22,34,154.54545454545453,10.988790170041083,-11.011209829958917,50.05095377254053
31243,132,42,90,214.28571428571428,14.084559348935187,-27.915440651064813,66.46533488348764
31244,55,14,41,292.85714285714283,10.948056365055635,-3.051943634944365,21.799597392459752
31245,45,1,44,4400.0,10.540718315201147,9.540718315201147,954.0718315201148
31247,300,13,287,2207.6923076923076,20.927838586490573,7.927838586490573,60.98337374223518
31248,117,11,106,963.6363636363636,13.473552274153455,2.4735522741534552,22.4868388559405
31249,85,7,78,1114.2857142857142,12.170070514619097,5.170070514619097,73.85815020884424
31250,62,17,45,264.70588235294116,11.233192999953776,-5.766807000046224,33.92239411791897
31251,43,11,32,290.90909090909093,10.45925070523025,-0.5407492947697499,4.915902679724999
31252,43,15,28,186.66666666666666,10.45925070523025,-4.54074929476975,30.271661965131663
31253,112,23,89,386.95652173913044,13.269883249226211,-9.730116750773789,42.30485543814691
31254,94,15,79,526.6666666666666,12.536674759488136,-2.463325240511864,16.422168270079094
31255,35,3,32,1066.6666666666665,10.133380265346661,7.133380265346661,237.77934217822204
31256,54,10,44,440.00000000000006,10.907322560070186,0.9073225600701864,9.073225600701864
31257,60,25,35,140.0,11.151725389982879,-13.848274610017121,55.39309844006849
31258,88,13,75,576.9230769230769,12.292271929575442,-0.7077280704245581,5.444062080188909
31259,41,11,30,272.7272727272727,10.377783095259353,-0.6222169047406467,5.656517315824061
31260,38,11,27,245.45454545454547,10.255581680303006,-0.7444183196969938,6.76743926997267
31261,32,14,18,128.57142857142858,10.011178850390314,-3.988821149609686,28.491579640069187
31262,187,16,171,1068.75,16.324918623134867,0.32491862313486664,2.0307413945929165
31263,44,20,24,120.0,10.499984510215699,-9.500015489784301,47.50007744892151
31264,90,3,87,2900.0,12.37373953954634,9.37373953954634,312.4579846515447
31265,85,5,80,1600.0,12.170070514619097,7.170070514619097,143.40141029238194
31266,84,11,73,663.6363636363636,12.129336709633648,1.1293367096336482,10.266697360305892
31267,79,8,71,887.5,11.925667684706404,3.9256676847064043,49.07084605883006
31268,267,25,242,968.0,19.583623021970766,-5.416376978029234,21.665507912116936
31269,43,5,38,760.0,10.45925070523025,5.45925070523025,109.18501410460499
31270,123,14,109,778.5714285714286,13.717955104066148,-0.2820448959338524,2.014606399527517
31271,50,14,36,257.14285714285717,10.744387340128391,-3.255612659871609,23.254376141940064
31272,97,28,69,246.42857142857144,12.658876174444481,-15.341123825555519,54.78972794841257
31273,47,9,38,422.22222222222223,10.622185925172046,1.6221859251720456,18.024288057467174
31274,247,1,246,24600.0,18.76894692226179,17.76894692226179,1776.894692226179
31275,55,1,54,5400.0,10.948056365055635,9.948056365055635,994.8056365055635
31276,137,23,114,495.65217391304344,14.288228373862431,-8.711771626137569,37.87726793972856
31277,100,28,72,257.14285714285717,12.781077589400827,-15.218922410599173,54.35329432356848
31278,37,10,27,270.0,10.214847875317558,0.21484787531755778,2.148478753175578
31279,49,16,33,206.25,10.703653535142942,-5.2963464648570575,33.10216540535661
31280,122,13,109,838.4615384615385,13.6772212990807,0.6772212990806992,5.209394608313071
31281,78,5,73,1460.0,11.884933879720956,6.884933879720956,137.6986775944191
31282,38,5,33,660.0,10.255581680303006,5.255581680303006,105.11163360606012
31283,30,12,18,150.0,9.929711240419417,-2.070288759580583,17.25240632983819
31284,27,15,12,80.0,9.80750982546307,-5.19249017453693,34.61660116357954
31286,194,14,180,1285.7142857142858,16.610055258033007,2.6100552580330074,18.64325184309291
31287,33,17,16,94.11764705882352,10.051912655375762,-6.948087344624238,40.8711020272014
31288,77,22,55,250.0,11.844200074735507,-10.155799925264493,46.16272693302042
31290,41,5,36,720.0,10.377783095259353,5.377783095259353,107.55566190518707
31291,87,14,73,521.4285714285714,12.251538124589993,-1.7484618754100065,12.489013395785761
31292,51,16,35,218.75,10.78512114511384,-5.214878854886161,32.5929928430385
31293,245,5,240,4800.0,18.68747931229089,13.68747931229089,273.7495862458178
31294,47,10,37,370.0,10.622185925172046,0.6221859251720456,6.221859251720456
31295,55,4,51,1275.0,10.948056365055635,6.948056365055635,173.70140912639087
31296,134,8,126,1575.0,14.166026958906084,6.166026958906084,77.07533698632605
31298,50,10,40,400.0,10.744387340128391,0.7443873401283909,7.44387340128391
31299,31,12,19,158.33333333333331,9.970445045404865,-2.0295549545951346,16.912957954959452
31300,24,11,13,118.18181818181819,9.685308410506725,-1.3146915894932754,11.95174172266614
31301,125,14,111,792.8571428571429,13.799422714037046,-0.20057728596295377,1.432694899735384
31302,77,19,58,305.2631578947369,11.844200074735507,-7.155799925264493,37.66210486981312
31303,124,12,112,933.3333333333334,13.758688909051596,1.758688909051596,14.6557409087633
31304,80,7,73,1042.857142857143,11.966401489691853,4.966401489691853,70.94859270988361
31305,37,8,29,362.5,10.214847875317558,2.214847875317558,27.685598441469473
31306,90,10,80,800.0,12.37373953954634,2.3737395395463405,23.737395395463405
31307,54,5,49,980.0000000000001,10.907322560070186,5.907322560070186,118.14645120140372
31308,53,7,46,657.1428571428571,10.866588755084738,3.866588755084738,55.236982215496255
31309,27,11,16,145.45454545454547,9.80750982546307,-1.19249017453693,10.840819768517546
31310,33,11,22,200.0,10.051912655375762,-0.9480873446242377,8.618975860220344
31311,197,16,181,1131.25,16.73225667298935,0.7322566729893509,4.576604206183443
31312,46,9,37,411.1111111111111,10.581452120186597,1.5814521201865972,17.571690224295526
31313,45,7,38,542.8571428571429,10.540718315201147,3.540718315201147,50.58169021715925
31314,208,8,200,2500.0,17.18032852782929,9.180328527829289,114.75410659786611
31315,23,19,4,21.052631578947366,9.644574605521276,-9.355425394478724,49.239081023572226
31316,21,19,2,10.526315789473683,9.563106995550378,-9.436893004449622,49.6678579181559
31317,14,17,-3,17.647058823529413,9.277970360652237,-7.722029639347763,45.423703760869195
31318,24,9,15,166.66666666666669,9.685308410506725,0.6853084105067246,7.614537894519163
31319,45,24,21,87.5,10.540718315201147,-13.459281684798853,56.08034035332855
31320,138,15,123,819.9999999999999,14.328962178847878,-0.6710378211521224,4.473585474347483
31321,62,18,44,244.44444444444446,11.233192999953776,-6.766807000046224,37.593372222479026
31323,206,11,195,1772.7272727272727,17.098860917858392,6.098860917858392,55.44419016234902
31324,77,18,59,327.77777777777777,11.844200074735507,-6.155799925264493,34.198888473691625
31325,51,13,38,292.30769230769226,10.78512114511384,-2.2148788548861607,17.037529652970466
31326,17,9,8,88.88888888888889,9.400171775608584,0.40017177560858386,4.446353062317598
31327,52,14,38,271.42857142857144,10.825854950099288,-3.1741450499007122,22.672464642147943
31328,59,12,47,391.66666666666663,11.11099158499743,-0.8890084150025697,7.408403458354747
31330,83,14,69,492.8571428571429,12.088602904648198,-1.911397095351802,13.652836395370013
31331,27,3,24,800.0,9.80750982546307,6.80750982546307,226.91699418210231
31332,54,13,41,315.38461538461536,10.907322560070186,-2.0926774399298136,16.097518768690875
31333,81,17,64,376.4705882352941,12.007135294677301,-4.992864705322699,29.36979238425117
31334,11,18,-7,38.88888888888889,9.155768945695892,-8.844231054304108,49.13461696835616
31335,169,32,137,428.125,15.591710133396788,-16.408289866603212,51.27590583313504
31336,41,18,23,127.77777777777777,10.377783095259353,-7.622216904740647,42.345649470781375
31337,72,6,66,1100.0,11.640531049808263,5.6405310498082635,94.00885083013773
31338,27,7,20,285.7142857142857,9.80750982546307,2.80750982546307,40.107283220900996
31339,90,1,89,8900.0,12.37373953954634,11.37373953954634,1137.373953954634
31340,33,17,16,94.11764705882352,10.051912655375762,-6.948087344624238,40.8711020272014
31380,9,6,3,50.0,9.074301335724993,3.074301335724993,51.23835559541655
31381,5,8,-3,37.5,8.9113661157832,0.9113661157831991,11.39207644728999
31383,9,2,7,350.0,9.074301335724993,7.074301335724993,353.7150667862496
31385,3,11,-8,72.72727272727273,8.8298985058123,-2.1701014941876995,19.72819540170636
31386,8,10,-2,20.0,9.033567530739544,-0.9664324692604556,9.664324692604556
31387,2,6,-4,66.66666666666666,8.789164700826852,2.789164700826852,46.4860783471142
31389,6,6,0,0.0,8.952099920768648,2.9520999207686476,49.201665346144125
31390,26,14,12,85.71428571428571,9.766776020477622,-4.2332239795223785,30.23731413944556
31391,44,14,30,214.28571428571428,10.499984510215699,-3.5000154897843014,25.000110641316436
31392,25,12,13,108.33333333333333,9.726042215492173,-2.273957784507827,18.94964820423189
31393,36,14,22,157.14285714285714,10.17411407033211,-3.8258859296678907,27.327756640484935
31394,28,15,13,86.66666666666667,9.84824363044852,-5.15175636955148,34.345042463676535
31395,27,8,19,237.5,9.80750982546307,1.80750982546307,22.593872818288375
31396,7,9,-2,22.22222222222222,8.992833725754096,-0.007166274245903992,0.07962526939893325
31398,8,1,7,700.0,9.033567530739544,8.033567530739544,803.3567530739545
31399,6,6,0,0.0,8.952099920768648,2.9520999207686476,49.201665346144125
31400,62,15,47,313.3333333333333,11.233192999953776,-3.7668070000462244,25.11204666697483
31401,42,6,36,600.0,10.418516900244802,4.418516900244802,73.64194833741337
31402,24,10,14,140.0,9.685308410506725,-0.31469158949327536,3.1469158949327536
31403,20,2,18,900.0,9.52237319056493,7.522373190564929,376.11865952824644
31404,47,1,46,4600.0,10.622185925172046,9.622185925172046,962.2185925172046
31405,28,2,26,1300.0,9.84824363044852,7.84824363044852,392.412181522426
31406,38,17,21,123.52941176470588,10.255581680303006,-6.744418319696994,39.67304893939408
31407,29,14,15,107.14285714285714,9.888977435433969,-4.111022564566031,29.364446889757367
31408,55,11,44,400.0,10.948056365055635,-0.05194363494436516,0.4722148631305923
31411,28,11,17,154.54545454545453,9.84824363044852,-1.1517563695514799,10.470512450467998
31412,31,2,29,1450.0,9.970445045404865,7.970445045404865,398.52225227024326
31413,27,14,13,92.85714285714286,9.80750982546307,-4.19249017453693,29.9463583895495
31414,28,11,17,154.54545454545453,9.84824363044852,-1.1517563695514799,10.470512450467998
31415,21,17,4,23.52941176470588,9.563106995550378,-7.436893004449622,43.74642943793896
31416,13,8,5,62.5,9.237236555666788,1.2372365556667884,15.465456945834855
31417,51,3,48,1600.0,10.78512114511384,7.785121145113839,259.50403817046134
31418,62,9,53,588.8888888888889,11.233192999953776,2.2331929999537756,24.813255555041952
31419,45,12,33,275.0,10.540718315201147,-1.459281684798853,12.160680706657107
31420,53,19,34,178.94736842105263,10.866588755084738,-8.133411244915262,42.807427604817164
31421,131,7,124,1771.4285714285716,14.043825543949737,7.043825543949737,100.62607919928195
31422,14,16,-2,12.5,9.277970360652237,-6.722029639347763,42.01268524592352
31423,32,1,31,3100.0,10.011178850390314,9.011178850390314,901.1178850390314
31424,53,5,48,960.0,10.866588755084738,5.866588755084738,117.33177510169477
31425,29,5,24,480.0,9.888977435433969,4.888977435433969,97.77954870867937
31426,136,12,124,1033.3333333333335,14.24749456887698,2.2474945688769807,18.72912140730817
31427,6,11,-5,45.45454545454545,8.952099920768648,-2.0479000792313524,18.61727344755775
31428,4,6,-2,33.33333333333333,8.87063231079775,2.8706323107977507,47.84387184662918
31429,22,18,4,22.22222222222222,9.603840800535828,-8.396159199464172,46.64532888591207
31500,39,12,27,225.0,10.296315485288455,-1.7036845147115454,14.197370955929545
31501,28,5,23,459.99999999999994,9.84824363044852,4.84824363044852,96.9648726089704
31502,13,10,3,30.0,9.237236555666788,-0.7627634443332116,7.627634443332116
31503,122,6,116,1933.3333333333333,13.6772212990807,7.677221299080699,127.95368831801166
31504,74,18,56,311.11111111111114,11.72199865977916,-6.27800134022084,34.87778522344911
31505,47,20,27,135.0,10.622185925172046,-9.377814074827954,46.88907037413978
31506,78,14,64,457.1428571428571,11.884933879720956,-2.115066120279044,15.107615144850314
31507,129,9,120,1333.3333333333335,13.96235793397884,4.96235793397884,55.13731037754267
31508,23,15,8,53.333333333333336,9.644574605521276,-5.355425394478724,35.70283596319149
31510,8,1,7,700.0,9.033567530739544,8.033567530739544,803.3567530739545
31511,29,9,20,222.22222222222223,9.888977435433969,0.8889774354339686,9.877527060377428
31512,27,5,22,440.00000000000006,9.80750982546307,4.80750982546307,96.1501965092614
31513,42,18,24,133.33333333333331,10.418516900244802,-7.581483099755198,42.11935055419554
31514,36,8,28,350.0,10.17411407033211,2.1741140703321093,27.176425879151367
31515,25,11,14,127.27272727272727,9.726042215492173,-1.273957784507827,11.581434404616608
31516,28,18,10,55.55555555555556,9.84824363044852,-8.15175636955148,45.28753538639711
31517,34,9,25,277.77777777777777,10.092646460361212,1.0926464603612125,12.140516226235693
31518,30,12,18,150.0,9.929711240419417,-2.070288759580583,17.25240632983819
31519,82,5,77,1540.0,12.047869099662751,7.047869099662751,140.957381993255
31520,33,5,28,560.0,10.051912655375762,5.051912655375762,101.03825310751525
31522,28,15,13,86.66666666666667,9.84824363044852,-5.15175636955148,34.345042463676535
31523,47,11,36,327.2727272727273,10.622185925172046,-0.37781407482795437,3.434673407526858
31524,60,11,49,445.45454545454544,11.151725389982879,0.15172538998287877,1.3793217271170797
31525,45,18,27,150.0,10.540718315201147,-7.459281684798853,41.44045380443807
31526,13,13,0,0.0,9.237236555666788,-3.7627634443332116,28.94433418717855
31527,36,8,28,350.0,10.17411407033211,2.1741140703321093,27.176425879151367
31528,50,13,37,284.61538461538464,10.744387340128391,-2.255612659871609,17.350866614396992
31529,27,2,25,1250.0,9.80750982546307,7.80750982546307,390.3754912731535
31530,22,14,8,57.14285714285714,9.603840800535828,-4.396159199464172,31.4011371390298
31531,76,14,62,442.8571428571429,11.803466269750057,-2.196533730249943,15.689526644642449
31532,38,12,26,216.66666666666666,10.255581680303006,-1.7444183196969938,14.536819330808282
31533,32,9,23,255.55555555555554,10.011178850390314,1.0111788503903139,11.235320559892376
31534,48,6,42,700.0,10.662919730157494,4.662919730157494,77.71532883595823
31535,18,12,6,50.0,9.440905580594032,-2.5590944194059677,21.325786828383066
31536,36,18,18,100.0,10.17411407033211,-7.825885929667891,43.477144053710504
31537,12,11,1,9.090909090909092,9.19650275068134,-1.80349724931866,16.395429539260544
31538,12,9,3,33.33333333333333,9.19650275068134,0.19650275068133993,2.1833638964593325
31539,6,1,5,500.0,8.952099920768648,7.952099920768648,795.2099920768648
31540,24,6,18,300.0,9.685308410506725,3.6853084105067246,61.421806841778746
31541,38,15,23,153.33333333333334,10.255581680303006,-4.744418319696994,31.62945546464663
31542,8,1,7,700.0,9.033567530739544,8.033567530739544,803.3567530739545
31543,24,7,17,242.85714285714283,9.685308410506725,2.6853084105067246,38.361548721524635
31544,17,3,14,466.6666666666667,9.400171775608584,6.400171775608584,213.3390591869528
31546,11,3,8,266.66666666666663,9.155768945695892,6.1557689456958915,205.19229818986307
31600,43,5,38,760.0,10.45925070523025,5.45925070523025,109.18501410460499
31601,51,12,39,325.0,10.78512114511384,-1.2148788548861607,10.123990457384673
31602,300,32,268,837.5,20.927838586490573,-11.072161413509427,34.60050441721696
31603,80,1,79,7900.0,11.966401489691853,10.966401489691853,1096.6401489691852
31604,23,11,12,109.09090909090908,9.644574605521276,-1.3554253944787238,12.32204904071567
31605,44,11,33,300.0,10.499984510215699,-0.5000154897843014,4.545595361675468
31606,42,5,37,740.0,10.418516900244802,5.418516900244802,108.37033800489604
31607,21,9,12,133.33333333333331,9.563106995550378,0.5631069955503776,6.256744395004195
31608,22,11,11,100.0,9.603840800535828,-1.3961591994641722,12.692356358765203
31610,50,12,38,316.66666666666663,10.744387340128391,-1.255612659871609,10.46343883226341
31611,59,1,58,5800.0,11.11099158499743,10.11099158499743,1011.099158499743
31612,58,22,36,163.63636363636365,11.070257780011982,-10.929742219988018,49.68064645449099
31615,64,6,58,966.6666666666666,11.314660609924672,5.3146606099246725,88.57767683207788
31616,60,5,55,1100.0,11.151725389982879,6.151725389982879,123.03450779965756
31618,38,5,33,660.0,10.255581680303006,5.255581680303006,105.11163360606012
31619,64,17,47,276.4705882352941,11.314660609924672,-5.6853393900753275,33.44317288279605
31620,152,26,126,484.6153846153846,14.899235448644161,-11.100764551355839,42.69524827444553
31621,31,14,17,121.42857142857142,9.970445045404865,-4.029554954595135,28.782535389965247
31622,41,26,15,57.692307692307686,10.377783095259353,-15.622216904740647,60.08544963361787
31623,136,17,119,700.0,14.24749456887698,-2.7525054311230193,16.1912084183707
31624,92,7,85,1214.2857142857142,12.455207149517237,5.455207149517237,77.9315307073891
31625,50,6,44,733.3333333333333,10.744387340128391,4.744387340128391,79.07312233547317
31626,27,9,18,200.0,9.80750982546307,0.8075098254630699,8.97233139403411
31627,120,16,104,650.0,13.595753689109802,-2.4042463108901977,15.026539443063736
31628,75,2,73,3650.0,11.762732464764609,9.762732464764609,488.1366232382304
31629,29,6,23,383.33333333333337,9.888977435433969,3.8889774354339686,64.81629059056614
31630,32,7,25,357.14285714285717,10.011178850390314,3.011178850390314,43.01684071986163
31631,38,14,24,171.42857142857142,10.255581680303006,-3.744418319696994,26.745845140692815
31632,33,4,29,725.0,10.051912655375762,6.051912655375762,151.29781638439405
31633,36,4,32,800.0,10.17411407033211,6.174114070332109,154.35285175830273
31634,92,10,82,819.9999999999999,12.455207149517237,2.4552071495172374,24.552071495172374
31635,29,9,20,222.22222222222223,9.888977435433969,0.8889774354339686,9.877527060377428
31636,46,8,38,475.0,10.581452120186597,2.581452120186597,32.268151502332465
31638,65,5,60,1200.0,11.355394414910123,6.355394414910123,127.10788829820245
31639,41,12,29,241.66666666666666,10.377783095259353,-1.6222169047406467,13.518474206172057
31640,61,14,47,335.7142857142857,11.192459194968327,-2.807540805031673,20.053862893083377
31641,47,16,31,193.75,10.622185925172046,-5.377814074827954,33.611337967674714
31642,63,17,46,270.5882352941177,11.273926804939224,-5.726073195060776,33.6827835003575
31643,29,12,17,141.66666666666669,9.888977435433969,-2.1110225645660314,17.591854704716926
31644,41,18,23,127.77777777777777,10.377783095259353,-7.622216904740647,42.345649470781375
31645,29,9,20,222.22222222222223,9.888977435433969,0.8889774354339686,9.877527060377428
31646,167,6,161,2683.333333333333,15.510242523425891,9.510242523425891,158.5040420570982
31647,176,11,165,1500.0,15.87684676829493,4.87684676829493,44.334970620863004
31648,88,13,75,576.9230769230769,12.292271929575442,-0.7077280704245581,5.444062080188909
31649,65,16,49,306.25,11.355394414910123,-4.644605585089877,29.028784906811733
31650,173,22,151,686.3636363636364,15.754645353338585,-6.245354646661415,28.387975666642795
31651,47,19,28,147.36842105263156,10.622185925172046,-8.377814074827954,44.09375828856818
31652,107,15,92,613.3333333333334,13.066214224298967,-1.9337857757010326,12.891905171340218
31653,112,6,106,1766.6666666666667,13.269883249226211,7.269883249226211,121.16472082043686
31654,58,8,50,625.0,11.070257780011982,3.070257780011982,38.378222250149776
31655,157,10,147,1470.0,15.102904473571405,5.102904473571405,51.029044735714045
31656,43,12,31,258.33333333333337,10.45925070523025,-1.5407492947697499,12.839577456414583
31657,33,11,22,200.0,10.051912655375762,-0.9480873446242377,8.618975860220344
31658,24,3,21,700.0,9.685308410506725,6.685308410506725,222.84361368355746
31659,25,10,15,150.0,9.726042215492173,-0.27395778450782693,2.7395778450782693
31661,65,10,55,550.0,11.355394414910123,1.3553944149101227,13.553944149101227
31662,45,10,35,350.0,10.540718315201147,0.540718315201147,5.40718315201147
31663,23,13,10,76.92307692307693,9.644574605521276,-3.355425394478724,25.81096457291326
31664,31,3,28,933.3333333333334,9.970445045404865,6.970445045404865,232.3481681801622
31665,29,9,20,222.22222222222223,9.888977435433969,0.8889774354339686,9.877527060377428
31666,122,5,117,2340.0,13.6772212990807,8.6772212990807,173.54442598161398
31667,37,6,31,516.6666666666667,10.214847875317558,4.214847875317558,70.24746458862596
31668,43,19,24,126.3157894736842,10.45925070523025,-8.54074929476975,44.95131207773553
31669,82,19,63,331.57894736842104,12.047869099662751,-6.952130900337249,36.59016263335394
31670,123,27,96,355.55555555555554,13.717955104066148,-13.282044895933852,49.192758873829085
31671,3,14,-11,78.57142857142857,8.8298985058123,-5.1701014941876995,36.929296387055
31672,27,2,25,1250.0,9.80750982546307,7.80750982546307,390.3754912731535
31673,56,11,45,409.09090909090907,10.988790170041083,-0.011209829958916728,0.10190754508106116
31674,100,4,96,2400.0,12.781077589400827,8.781077589400827,219.52693973502068
31675,44,8,36,450.0,10.499984510215699,2.4999845102156986,31.24980637769623
31676,57,12,45,375.0,11.029523975026532,-0.9704760249734683,8.087300208112236
31677,40,10,30,300.0,10.337049290273903,0.33704929027390307,3.3704929027390307
31678,24,1,23,2300.0,9.685308410506725,8.685308410506725,868.5308410506725
31680,47,3,44,1466.6666666666665,10.622185925172046,7.622185925172046,254.07286417240152
31699,113,28,85,303.57142857142856,13.310617054211662,-14.689382945788338,52.462081949244066
31700,5,19,-14,73.68421052631578,8.9113661157832,-10.0886338842168,53.09807307482527
31701,8,14,-6,42.857142857142854,9.033567530739544,-4.966432469260456,35.474517637574685
31702,6,6,0,0.0,8.952099920768648,2.9520999207686476,49.201665346144125
31703,13,10,3,30.0,9.237236555666788,-0.7627634443332116,7.627634443332116
31704,4,3,1,33.33333333333333,8.87063231079775,5.870632310797751,195.68774369325837
31705,19,9,10,111.11111111111111,9.48163938557948,0.4816393855794807,5.351548728660896
31706,5,5,0,0.0,8.9113661157832,3.911366115783199,78.22732231566398
31707,9,13,-4,30.76923076923077,9.074301335724993,-3.925698664275007,30.19768203288467
31708,9,13,-4,30.76923076923077,9.074301335724993,-3.925698664275007,30.19768203288467
31710,3,1,2,200.0,8.8298985058123,7.8298985058123005,782.98985058123
31711,6,6,0,0.0,8.952099920768648,2.9520999207686476,49.201665346144125
31712,20,10,10,100.0,9.52237319056493,-0.47762680943507085,4.7762680943507085
31713,8,5,3,60.0,9.033567530739544,4.033567530739544,80.6713506147909
31714,6,11,-5,45.45454545454545,8.952099920768648,-2.0479000792313524,18.61727344755775
31715,15,10,5,50.0,9.318704165637685,-0.6812958343623148,6.812958343623148
31716,18,5,13,260.0,9.440905580594032,4.440905580594032,88.81811161188065
31717,8,9,-1,11.11111111111111,9.033567530739544,0.03356753073954444,0.372972563772716
31718,4,13,-9,69.23076923076923,8.87063231079775,-4.129367689202249,31.7643668400173
31720,14,17,-3,17.647058823529413,9.277970360652237,-7.722029639347763,45.423703760869195
31721,18,9,9,100.0,9.440905580594032,0.4409055805940323,4.898950895489248
31722,5,15,-10,66.66666666666666,8.9113661157832,-6.088633884216801,40.590892561445344
31723,1,11,-10,90.9090909090909,8.748430895841404,-2.2515691041585963,20.468810037805422
31724,1,8,-7,87.5,8.748430895841404,0.7484308958414037,9.355386198017545
31725,17,11,6,54.54545454545454,9.400171775608584,-1.5998282243914161,14.543892949012873
31726,12,7,5,71.42857142857143,9.19650275068134,2.19650275068134,31.37861072401914
31727,23,17,6,35.294117647058826,9.644574605521276,-7.355425394478724,43.26720820281602
31728,5,7,-2,28.57142857142857,8.9113661157832,1.9113661157831991,27.305230225474276
31800,6,7,-1,14.285714285714285,8.952099920768648,1.9520999207686476,27.887141725266396
31801,42,6,36,600.0,10.418516900244802,4.418516900244802,73.64194833741337
31802,11,2,9,450.0,9.155768945695892,7.1557689456958915,357.7884472847946
31803,13,2,11,550.0,9.237236555666788,7.237236555666788,361.86182778333944
31804,17,9,8,88.88888888888889,9.400171775608584,0.40017177560858386,4.446353062317598
31805,11,3,8,266.66666666666663,9.155768945695892,6.1557689456958915,205.19229818986307
31806,21,14,7,50.0,9.563106995550378,-4.436893004449622,31.692092888925878
31808,13,4,9,225.0,9.237236555666788,5.237236555666788,130.93091389166972
31811,7,16,-9,56.25,8.992833725754096,-7.007166274245904,43.794789214036896
31812,22,12,10,83.33333333333334,9.603840800535828,-2.396159199464172,19.967993328868104
31813,8,12,-4,33.33333333333333,9.033567530739544,-2.9664324692604556,24.720270577170464
31814,2,8,-6,75.0,8.789164700826852,0.7891647008268521,9.864558760335651
31815,5,8,-3,37.5,8.9113661157832,0.9113661157831991,11.39207644728999
31816,14,14,0,0.0,9.277970360652237,-4.722029639347763,33.72878313819831
31817,9,1,8,800.0,9.074301335724993,8.074301335724993,807.4301335724992
31818,2,10,-8,80.0,8.789164700826852,-1.210835299173148,12.10835299173148
31819,3,4,-1,25.0,8.8298985058123,4.8298985058123005,120.74746264530751
31820,10,4,6,150.0,9.115035140710443,5.115035140710443,127.87587851776108
31822,7,17,-10,58.82352941176471,8.992833725754096,-8.007166274245904,47.10097808379943
31824,5,4,1,25.0,8.9113661157832,4.911366115783199,122.78415289457998
31825,3,14,-11,78.57142857142857,8.8298985058123,-5.1701014941876995,36.929296387055
31826,9,16,-7,43.75,9.074301335724993,-6.925698664275007,43.2856166517188
31827,19,19,0,0.0,9.48163938557948,-9.51836061442052,50.09663481273957
31829,11,11,0,0.0,9.155768945695892,-1.8442310543041085,16.765736857310078
31831,5,7,-2,28.57142857142857,8.9113661157832,1.9113661157831991,27.305230225474276
31900,12,13,-1,7.6923076923076925,9.19650275068134,-3.80349724931866,29.25767114860508
31901,9,9,0,0.0,9.074301335724993,0.07430133572499287,0.8255703969443652
31902,15,8,7,87.5,9.318704165637685,1.3187041656376852,16.483802070471064
31903,35,1,34,3400.0,10.133380265346661,9.133380265346661,913.3380265346661
31904,20,16,4,25.0,9.52237319056493,-6.477626809435071,40.485167558969195
31905,12,6,6,100.0,9.19650275068134,3.19650275068134,53.275045844689
31906,9,12,-3,25.0,9.074301335724993,-2.925698664275007,24.38082220229173
31908,5,10,-5,50.0,8.9113661157832,-1.0886338842168009,10.886338842168009
31909,13,13,0,0.0,9.237236555666788,-3.7627634443332116,28.94433418717855
31910,15,15,0,0.0,9.318704165637685,-5.681295834362315,37.875305562415434
31912,12,10,2,20.0,9.19650275068134,-0.8034972493186601,8.0349724931866
31914,12,9,3,33.33333333333333,9.19650275068134,0.19650275068133993,2.1833638964593325
31915,10,8,2,25.0,9.115035140710443,1.115035140710443,13.937939258880538
31916,14,16,-2,12.5,9.277970360652237,-6.722029639347763,42.01268524592352
31917,56,10,46,459.99999999999994,10.988790170041083,0.9887901700410833,9.887901700410833
31918,20,12,8,66.66666666666666,9.52237319056493,-2.477626809435071,20.64689007862559
31919,13,5,8,160.0,9.237236555666788,4.237236555666788,84.74473111333577
31920,30,10,20,200.0,9.929711240419417,-0.070288759580583,0.70288759580583
31921,10,9,1,11.11111111111111,9.115035140710443,0.11503514071044307,1.2781682301160342
31923,13,9,4,44.44444444444444,9.237236555666788,0.23723655566678836,2.635961729630982
31924,25,9,16,177.77777777777777,9.726042215492173,0.7260422154921731,8.067135727690813
31926,27,11,16,145.45454545454547,9.80750982546307,-1.19249017453693,10.840819768517546
31927,10,8,2,25.0,9.115035140710443,1.115035140710443,13.937939258880538
31928,7,13,-6,46.15384615384615,8.992833725754096,-4.007166274245904,30.824355955737726
31929,16,2,14,700.0,9.359437970623135,7.359437970623135,367.9718985311568
31930,12,14,-2,14.285714285714285,9.19650275068134,-4.80349724931866,34.31069463799043
31931,24,4,20,500.0,9.685308410506725,5.685308410506725,142.13271026266813
31932,10,6,4,66.66666666666666,9.115035140710443,3.115035140710443,51.91725234517405
31933,27,3,24,800.0,9.80750982546307,6.80750982546307,226.91699418210231
31935,19,13,6,46.15384615384615,9.48163938557948,-3.5183606144205193,27.06431241861938
31936,15,10,5,50.0,9.318704165637685,-0.6812958343623148,6.812958343623148
31937,19,9,10,111.11111111111111,9.48163938557948,0.4816393855794807,5.351548728660896
31938,15,8,7,87.5,9.318704165637685,1.3187041656376852,16.483802070471064
31939,21,11,10,90.9090909090909,9.563106995550378,-1.4368930044496224,13.062663676814749
31940,32,10,22,220.00000000000003,10.011178850390314,0.011178850390313855,0.11178850390313855
31941,6,6,0,0.0,8.952099920768648,2.9520999207686476,49.201665346144125
31942,6,7,-1,14.285714285714285,8.952099920768648,1.9520999207686476,27.887141725266396
31943,3,9,-6,66.66666666666666,8.8298985058123,-0.1701014941876995,1.8900166020855498
31944,13,4,9,225.0,9.237236555666788,5.237236555666788,130.93091389166972
31945,12,14,-2,14.285714285714285,9.19650275068134,-4.80349724931866,34.31069463799043
31946,6,7,-1,14.285714285714285,8.952099920768648,1.9520999207686476,27.887141725266396
31947,68,20,48,240.0,11.477595829866468,-8.522404170133532,42.61202085066766
31948,9,9,0,0.0,9.074301335724993,0.07430133572499287,0.8255703969443652
31950,13,9,4,44.44444444444444,9.237236555666788,0.23723655566678836,2.635961729630982
31951,19,9,10,111.11111111111111,9.48163938557948,0.4816393855794807,5.351548728660896
31952,6,13,-7,53.84615384615385,8.952099920768648,-4.047900079231352,31.13769291716425
31953,7,3,4,133.33333333333331,8.992833725754096,5.992833725754096,199.76112419180322
31954,10,7,3,42.857142857142854,9.115035140710443,2.115035140710443,30.2147877244349
31955,12,12,0,0.0,9.19650275068134,-2.80349724931866,23.362477077655498
31956,22,2,20,1000.0,9.603840800535828,7.603840800535828,380.1920400267914
31957,8,13,-5,38.46153846153847,9.033567530739544,-3.9664324692604556,30.511018994311197
31958,13,5,8,160.0,9.237236555666788,4.237236555666788,84.74473111333577
31959,26,12,14,116.66666666666667,9.766776020477622,-2.2332239795223785,18.610199829353157
31960,13,5,8,160.0,9.237236555666788,4.237236555666788,84.74473111333577
31961,9,8,1,12.5,9.074301335724993,1.0743013357249929,13.42876669656241
31962,7,5,2,40.0,8.992833725754096,3.992833725754096,79.85667451508192
31963,15,10,5,50.0,9.318704165637685,-0.6812958343623148,6.812958343623148
31964,3,9,-6,66.66666666666666,8.8298985058123,-0.1701014941876995,1.8900166020855498
31966,8,8,0,0.0,9.033567530739544,1.0335675307395444,12.919594134244306
31967,9,9,0,0.0,9.074301335724993,0.07430133572499287,0.8255703969443652
31968,34,2,32,1600.0,10.092646460361212,8.092646460361212,404.6323230180606
31969,20,19,1,5.263157894736842,9.52237319056493,-9.47762680943507,49.88224636544774
31970,37,13,24,184.6153846153846,10.214847875317558,-2.785152124682442,21.424247112941863
31971,16,9,7,77.77777777777779,9.359437970623135,0.3594379706231354,3.993755229145949
31972,14,9,5,55.55555555555556,9.277970360652237,0.2779703606522368,3.0885595628026308
31973,21,5,16,320.0,9.563106995550378,4.563106995550378,91.26213991100755
31974,10,4,6,150.0,9.115035140710443,5.115035140710443,127.87587851776108
31976,17,7,10,142.85714285714286,9.400171775608584,2.400171775608584,34.28816822297977
31977,15,10,5,50.0,9.318704165637685,-0.6812958343623148,6.812958343623148
31978,38,1,37,3700.0,10.255581680303006,9.255581680303006,925.5581680303006
31979,15,8,7,87.5,9.318704165637685,1.3187041656376852,16.483802070471064
31981,13,11,2,18.181818181818183,9.237236555666788,-1.7627634443332116,16.025122221211017
32000,19,8,11,137.5,9.48163938557948,1.4816393855794807,18.52049231974351
32001,15,8,7,87.5,9.318704165637685,1.3187041656376852,16.483802070471064
32002,15,10,5,50.0,9.318704165637685,-0.6812958343623148,6.812958343623148
32003,11,3,8,266.66666666666663,9.155768945695892,6.1557689456958915,205.19229818986307
32005,2,8,-6,75.0,8.789164700826852,0.7891647008268521,9.864558760335651
32006,13,9,4,44.44444444444444,9.237236555666788,0.23723655566678836,2.635961729630982
32008,45,8,37,462.5,10.540718315201147,2.540718315201147,31.758978940014337
32009,6,7,-1,14.285714285714285,8.952099920768648,1.9520999207686476,27.887141725266396
32012,19,16,3,18.75,9.48163938557948,-6.518360614420519,40.739753840128245
32014,46,17,29,170.58823529411765,10.581452120186597,-6.418547879813403,37.75616399890237
32017,4,10,-6,60.0,8.87063231079775,-1.1293676892022493,11.293676892022493
32018,5,12,-7,58.333333333333336,8.9113661157832,-3.088633884216801,25.738615701806673
32019,23,2,21,1050.0,9.644574605521276,7.644574605521276,382.2287302760638
32021,26,14,12,85.71428571428571,9.766776020477622,-4.2332239795223785,30.23731413944556
32022,5,9,-4,44.44444444444444,8.9113661157832,-0.08863388421680085,0.9848209357422317
32023,8,14,-6,42.857142857142854,9.033567530739544,-4.966432469260456,35.474517637574685
32024,25,3,22,733.3333333333333,9.726042215492173,6.726042215492173,224.20140718307243
32025,40,3,37,1233.3333333333335,10.337049290273903,7.337049290273903,244.56830967579677
32026,12,6,6,100.0,9.19650275068134,3.19650275068134,53.275045844689
32027,29,9,20,222.22222222222223,9.888977435433969,0.8889774354339686,9.877527060377428
32028,8,8,0,0.0,9.033567530739544,1.0335675307395444,12.919594134244306
32029,17,7,10,142.85714285714286,9.400171775608584,2.400171775608584,34.28816822297977
32032,8,11,-3,27.27272727272727,9.033567530739544,-1.9664324692604556,17.876658811458686
32034,11,14,-3,21.428571428571427,9.155768945695892,-4.8442310543041085,34.60165038788649
32036,19,13,6,46.15384615384615,9.48163938557948,-3.5183606144205193,27.06431241861938
32037,9,10,-1,10.0,9.074301335724993,-0.9256986642750071,9.256986642750071
32038,6,14,-8,57.14285714285714,8.952099920768648,-5.047900079231352,36.056429137366806
32039,9,13,-4,30.76923076923077,9.074301335724993,-3.925698664275007,30.19768203288467
32040,27,12,15,125.0,9.80750982546307,-2.19249017453693,18.270751454474418
32043,8,6,2,33.33333333333333,9.033567530739544,3.0335675307395444,50.55945884565908
32044,5,9,-4,44.44444444444444,8.9113661157832,-0.08863388421680085,0.9848209357422317
32045,8,18,-10,55.55555555555556,9.033567530739544,-8.966432469260456,49.81351371811365
32046,20,13,7,53.84615384615385,9.52237319056493,-3.477626809435071,26.750975457192855
32047,6,16,-10,62.5,8.952099920768648,-7.047900079231352,44.04937549519595
32048,29,6,23,383.33333333333337,9.888977435433969,3.8889774354339686,64.81629059056614
32049,19,2,17,850.0,9.48163938557948,7.481639385579481,374.08196927897404
32050,6,5,1,20.0,8.952099920768648,3.9520999207686476,79.04199841537294
32051,10,12,-2,16.666666666666664,9.115035140710443,-2.884964859289557,24.041373827412972
32053,31,14,17,121.42857142857142,9.970445045404865,-4.029554954595135,28.782535389965247
32054,7,5,2,40.0,8.992833725754096,3.992833725754096,79.85667451508192
32055,20,4,16,400.0,9.52237319056493,5.522373190564929,138.05932976412322
32056,15,12,3,25.0,9.318704165637685,-2.681295834362315,22.34413195301929
32057,13,3,10,333.33333333333337,9.237236555666788,6.237236555666788,207.90788518889295
32058,7,13,-6,46.15384615384615,8.992833725754096,-4.007166274245904,30.824355955737726
32061,8,14,-6,42.857142857142854,9.033567530739544,-4.966432469260456,35.474517637574685
32062,7,14,-7,50.0,8.992833725754096,-5.007166274245904,35.76547338747074
32063,8,10,-2,20.0,9.033567530739544,-0.9664324692604556,9.664324692604556
32064,4,14,-10,71.42857142857143,8.87063231079775,-5.129367689202249,36.638340637158926
32065,7,12,-5,41.66666666666667,8.992833725754096,-3.007166274245904,25.0597189520492
32066,5,13,-8,61.53846153846154,8.9113661157832,-4.088633884216801,31.451029878590774
32067,13,14,-1,7.142857142857142,9.237236555666788,-4.762763444333212,34.019738888094366
32068,5,7,-2,28.57142857142857,8.9113661157832,1.9113661157831991,27.305230225474276
32073,2,13,-11,84.61538461538461,8.789164700826852,-4.210835299173148,32.39104076287037
32074,8,14,-6,42.857142857142854,9.033567530739544,-4.966432469260456,35.474517637574685
32075,5,25,-20,80.0,8.9113661157832,-16.0886338842168,64.3545355368672
32076,10,13,-3,23.076923076923077,9.115035140710443,-3.884964859289557,29.884345071458128
32077,6,14,-8,57.14285714285714,8.952099920768648,-5.047900079231352,36.056429137366806
32078,6,14,-8,57.14285714285714,8.952099920768648,-5.047900079231352,36.056429137366806
32079,5,6,-1,16.666666666666664,8.9113661157832,2.911366115783199,48.52276859638665
32080,12,7,5,71.42857142857143,9.19650275068134,2.19650275068134,31.37861072401914
32081,9,6,3,50.0,9.074301335724993,3.074301335724993,51.23835559541655
32082,7,8,-1,12.5,8.992833725754096,0.992833725754096,12.4104215719262
32083,5,13,-8,61.53846153846154,8.9113661157832,-4.088633884216801,31.451029878590774
32084,8,9,-1,11.11111111111111,9.033567530739544,0.03356753073954444,0.372972563772716
32085,2,5,-3,60.0,8.789164700826852,3.789164700826852,75.78329401653704
32086,4,15,-11,73.33333333333333,8.87063231079775,-6.129367689202249,40.862451261348326
32087,1,14,-13,92.85714285714286,8.748430895841404,-5.251569104158596,37.51120788684712
32088,2,9,-7,77.77777777777779,8.789164700826852,-0.21083529917314792,2.3426144352571994
32089,5,11,-6,54.54545454545454,8.9113661157832,-2.088633884216801,18.98758076560728
32090,0,15,-15,100.0,8.707697090855955,-6.292302909144045,41.9486860609603
32092,4,16,-12,75.0,8.87063231079775,-7.129367689202249,44.55854805751406
32094,4,18,-14,77.77777777777779,8.87063231079775,-9.12936768920225,50.718709384456936
32101,3,10,-7,70.0,8.8298985058123,-1.1701014941876995,11.701014941876995
32200,6,14,-8,57.14285714285714,8.952099920768648,-5.047900079231352,36.056429137366806
32201,8,11,-3,27.27272727272727,9.033567530739544,-1.9664324692604556,17.876658811458686
32203,12,5,7,140.0,9.19650275068134,4.19650275068134,83.9300550136268
32204,10,11,-1,9.090909090909092,9.115035140710443,-1.884964859289557,17.136044175359608
32205,7,3,4,133.33333333333331,8.992833725754096,5.992833725754096,199.76112419180322
32206,5,5,0,0.0,8.9113661157832,3.911366115783199,78.22732231566398
32207,4,11,-7,63.63636363636363,8.87063231079775,-2.1293676892022493,19.357888083656814
32209,4,1,3,300.0,8.87063231079775,7.870632310797751,787.063231079775
32210,7,6,1,16.666666666666664,8.992833725754096,2.992833725754096,49.880562095901595
32211,7,13,-6,46.15384615384615,8.992833725754096,-4.007166274245904,30.824355955737726
32212,4,8,-4,50.0,8.87063231079775,0.8706323107977507,10.882903884971885
32213,9,1,8,800.0,9.074301335724993,8.074301335724993,807.4301335724992
32214,14,13,1,7.6923076923076925,9.277970360652237,-3.722029639347763,28.630997225752026
32215,8,16,-8,50.0,9.033567530739544,-6.966432469260456,43.54020293287785
32216,8,13,-5,38.46153846153847,9.033567530739544,-3.9664324692604556,30.511018994311197
32218,10,9,1,11.11111111111111,9.115035140710443,0.11503514071044307,1.2781682301160342
32219,14,5,9,180.0,9.277970360652237,4.277970360652237,85.55940721304474
32220,8,12,-4,33.33333333333333,9.033567530739544,-2.9664324692604556,24.720270577170464
32221,3,7,-4,57.14285714285714,8.8298985058123,1.8298985058123005,26.141407225890006
32223,2,5,-3,60.0,8.789164700826852,3.789164700826852,75.78329401653704
32224,6,6,0,0.0,8.952099920768648,2.9520999207686476,49.201665346144125
32225,6,2,4,200.0,8.952099920768648,6.952099920768648,347.6049960384324
32226,65,24,41,170.83333333333331,11.355394414910123,-12.644605585089877,52.68585660454116
32228,7,4,3,75.0,8.992833725754096,4.992833725754096,124.8208431438524
32229,10,8,2,25.0,9.115035140710443,1.115035140710443,13.937939258880538
32230,7,14,-7,50.0,8.992833725754096,-5.007166274245904,35.76547338747074
32231,12,16,-4,25.0,9.19650275068134,-6.80349724931866,42.52185780824163
32234,9,11,-2,18.181818181818183,9.074301335724993,-1.9256986642750071,17.506351493409156
32235,10,2,8,400.0,9.115035140710443,7.115035140710443,355.75175703552213
32236,7,7,0,0.0,8.992833725754096,1.992833725754096,28.469053225058516
32237,11,5,6,120.0,9.155768945695892,4.1557689456958915,83.11537891391782
32238,6,1,5,500.0,8.952099920768648,7.952099920768648,795.2099920768648
32242,8,11,-3,27.27272727272727,9.033567530739544,-1.9664324692604556,17.876658811458686
32243,12,12,0,0.0,9.19650275068134,-2.80349724931866,23.362477077655498
32244,1,8,-7,87.5,8.748430895841404,0.7484308958414037,9.355386198017545
32246,3,8,-5,62.5,8.8298985058123,0.8298985058123005,10.373731322653757
32247,4,11,-7,63.63636363636363,8.87063231079775,-2.1293676892022493,19.357888083656814
32248,4,4,0,0.0,8.87063231079775,4.870632310797751,121.76580776994376
32250,5,10,-5,50.0,8.9113661157832,-1.0886338842168009,10.886338842168009
32251,2,5,-3,60.0,8.789164700826852,3.789164700826852,75.78329401653704
32252,4,9,-5,55.55555555555556,8.87063231079775,-0.12936768920224928,1.4374187689138809
32255,4,7,-3,42.857142857142854,8.87063231079775,1.8706323107977507,26.723318725682155
32258,5,18,-13,72.22222222222221,8.9113661157832,-9.0886338842168,50.49241046787112
32259,8,10,-2,20.0,9.033567530739544,-0.9664324692604556,9.664324692604556
32260,13,18,-5,27.77777777777778,9.237236555666788,-8.762763444333212,48.682019135184504
32261,9,11,-2,18.181818181818183,9.074301335724993,-1.9256986642750071,17.506351493409156
32262,15,10,5,50.0,9.318704165637685,-0.6812958343623148,6.812958343623148
32263,7,5,2,40.0,8.992833725754096,3.992833725754096,79.85667451508192
32264,3,10,-7,70.0,8.8298985058123,-1.1701014941876995,11.701014941876995
32265,16,3,13,433.3333333333333,9.359437970623135,6.359437970623135,211.98126568743785
32266,6,8,-2,25.0,8.952099920768648,0.9520999207686476,11.901249009608094
32268,7,10,-3,30.0,8.992833725754096,-1.007166274245904,10.07166274245904
32270,6,1,5,500.0,8.952099920768648,7.952099920768648,795.2099920768648
32271,4,9,-5,55.55555555555556,8.87063231079775,-0.12936768920224928,1.4374187689138809
32272,5,10,-5,50.0,8.9113661157832,-1.0886338842168009,10.886338842168009
32274,4,9,-5,55.55555555555556,8.87063231079775,-0.12936768920224928,1.4374187689138809
32275,1,12,-11,91.66666666666666,8.748430895841404,-3.2515691041585963,27.096409201321634
32276,9,8,1,12.5,9.074301335724993,1.0743013357249929,13.42876669656241
32277,3,7,-4,57.14285714285714,8.8298985058123,1.8298985058123005,26.141407225890006
32278,6,5,1,20.0,8.952099920768648,3.9520999207686476,79.04199841537294
32279,7,7,0,0.0,8.992833725754096,1.992833725754096,28.469053225058516
32280,8,2,6,300.0,9.033567530739544,7.033567530739544,351.6783765369772
32281,8,9,-1,11.11111111111111,9.033567530739544,0.03356753073954444,0.372972563772716
32282,4,7,-3,42.857142857142854,8.87063231079775,1.8706323107977507,26.723318725682155
32283,5,2,3,150.0,8.9113661157832,6.911366115783199,345.56830578916
32288,4,1,3,300.0,8.87063231079775,7.870632310797751,787.063231079775
32289,6,5,1,20.0,8.952099920768648,3.9520999207686476,79.04199841537294
32290,5,9,-4,44.44444444444444,8.9113661157832,-0.08863388421680085,0.9848209357422317
32293,6,1,5,500.0,8.952099920768648,7.952099920768648,795.2099920768648
32294,6,6,0,0.0,8.952099920768648,2.9520999207686476,49.201665346144125
32295,7,11,-4,36.36363636363637,8.992833725754096,-2.007166274245904,18.24696612950822
32296,4,12,-8,66.66666666666666,8.87063231079775,-3.1293676892022493,26.078064076685408
32297,7,4,3,75.0,8.992833725754096,4.992833725754096,124.8208431438524
32298,2,8,-6,75.0,8.789164700826852,0.7891647008268521,9.864558760335651
32301,19,11,8,72.72727272727273,9.48163938557948,-1.5183606144205193,13.803278312913811
32320,5,6,-1,16.666666666666664,8.9113661157832,2.911366115783199,48.52276859638665
32400,5,13,-8,61.53846153846154,8.9113661157832,-4.088633884216801,31.451029878590774
32401,4,12,-8,66.66666666666666,8.87063231079775,-3.1293676892022493,26.078064076685408
32402,15,16,-1,6.25,9.318704165637685,-6.681295834362315,41.758098964764464
32403,9,11,-2,18.181818181818183,9.074301335724993,-1.9256986642750071,17.506351493409156
32405,2,2,0,0.0,8.789164700826852,6.789164700826852,339.4582350413426
32406,16,4,12,300.0,9.359437970623135,5.359437970623135,133.9859492655784
32407,6,13,-7,53.84615384615385,8.952099920768648,-4.047900079231352,31.13769291716425
32408,9,5,4,80.0,9.074301335724993,4.074301335724993,81.48602671449986
32409,3,12,-9,75.0,8.8298985058123,-3.1701014941876995,26.417512451564164
32411,8,9,-1,11.11111111111111,9.033567530739544,0.03356753073954444,0.372972563772716
32412,8,12,-4,33.33333333333333,9.033567530739544,-2.9664324692604556,24.720270577170464
32413,11,4,7,175.0,9.155768945695892,5.1557689456958915,128.8942236423973
32414,11,5,6,120.0,9.155768945695892,4.1557689456958915,83.11537891391782
32415,12,10,2,20.0,9.19650275068134,-0.8034972493186601,8.0349724931866
32416,14,3,11,366.66666666666663,9.277970360652237,6.277970360652237,209.26567868840792
32417,8,14,-6,42.857142857142854,9.033567530739544,-4.966432469260456,35.474517637574685
32418,22,1,21,2100.0,9.603840800535828,8.603840800535828,860.3840800535828
32419,8,11,-3,27.27272727272727,9.033567530739544,-1.9664324692604556,17.876658811458686
32420,13,16,-3,18.75,9.237236555666788,-6.762763444333212,42.26727152708257
32421,10,10,0,0.0,9.115035140710443,-0.8849648592895569,8.84964859289557
32422,13,13,0,0.0,9.237236555666788,-3.7627634443332116,28.94433418717855
32423,12,6,6,100.0,9.19650275068134,3.19650275068134,53.275045844689
32424,5,5,0,0.0,8.9113661157832,3.911366115783199,78.22732231566398
32425,5,4,1,25.0,8.9113661157832,4.911366115783199,122.78415289457998
32426,10,7,3,42.857142857142854,9.115035140710443,2.115035140710443,30.2147877244349
32427,6,10,-4,40.0,8.952099920768648,-1.0479000792313524,10.479000792313524
32428,4,3,1,33.33333333333333,8.87063231079775,5.870632310797751,195.68774369325837
32429,19,10,9,90.0,9.48163938557948,-0.5183606144205193,5.183606144205193
32430,16,9,7,77.77777777777779,9.359437970623135,0.3594379706231354,3.993755229145949
32431,14,13,1,7.6923076923076925,9.277970360652237,-3.722029639347763,28.630997225752026
32432,11,5,6,120.0,9.155768945695892,4.1557689456958915,83.11537891391782
32433,9,5,4,80.0,9.074301335724993,4.074301335724993,81.48602671449986
32434,4,1,3,300.0,8.87063231079775,7.870632310797751,787.063231079775
32600,9,10,-1,10.0,9.074301335724993,-0.9256986642750071,9.256986642750071
32601,12,6,6,100.0,9.19650275068134,3.19650275068134,53.275045844689
32602,6,11,-5,45.45454545454545,8.952099920768648,-2.0479000792313524,18.61727344755775
32603,9,7,2,28.57142857142857,9.074301335724993,2.074301335724993,29.632876224642757
32604,8,4,4,100.0,9.033567530739544,5.033567530739544,125.83918826848861
32605,12,6,6,100.0,9.19650275068134,3.19650275068134,53.275045844689
32606,24,2,22,1100.0,9.685308410506725,7.685308410506725,384.26542052533625
32607,8,4,4,100.0,9.033567530739544,5.033567530739544,125.83918826848861
32608,10,9,1,11.11111111111111,9.115035140710443,0.11503514071044307,1.2781682301160342
32609,8,11,-3,27.27272727272727,9.033567530739544,-1.9664324692604556,17.876658811458686
33200,47,1,46,4600.0,10.622185925172046,9.622185925172046,962.2185925172046
